{
  "a": "l",
  "b": "m",
  "c": "s",
  "d": "u",
  "e": "x",
  "f": "a",
  "g": "b",
  "h": "r",
  "i": "c",
  "j": "t",
  "k": "f",
  "l": "q",
  "m": "z",
  "n": "d",
  "o": "i",
  "p": "h",
  "q": "v",
  "r": "e",
  "s": "n",
  "t": "w",
  "u": "o",
  "v": "g",
  "w": "p",
  "x": "j",
  "y": "y",
  "z": "k"
}