{
  "a": "f",
  "b": "c",
  "c": "g",
  "d": "q",
  "e": "b",
  "f": "z",
  "g": "o",
  "h": "e",
  "i": "l",
  "j": "m",
  "k": "k",
  "l": "d",
  "m": "s",
  "n": "v",
  "o": "h",
  "p": "x",
  "q": "w",
  "r": "j",
  "s": "u",
  "t": "t",
  "u": "a",
  "v": "n",
  "w": "i",
  "x": "p",
  "y": "r",
  "z": "y"
}