{
  "a": "c",
  "b": "g",
  "c": "r",
  "d": "y",
  "e": "f",
  "f": "s",
  "g": "w",
  "h": "u",
  "i": "j",
  "j": "q",
  "k": "t",
  "l": "m",
  "m": "i",
  "n": "p",
  "o": "b",
  "p": "o",
  "q": "d",
  "r": "e",
  "s": "k",
  "t": "n",
  "u": "x",
  "v": "a",
  "w": "h",
  "x": "l",
  "y": "v",
  "z": "z"
}