{
  "a": "s",
  "b": "w",
  "c": "a",
  "d": "t",
  "e": "c",
  "f": "x",
  "g": "m",
  "h": "u",
  "i": "p",
  "j": "z",
  "k": "f",
  "l": "k",
  "m": "y",
  "n": "r",
  "o": "e",
  "p": "n",
  "q": "h",
  "r": "b",
  "s": "d",
  "t": "o",
  "u": "i",
  "v": "j",
  "w": "q",
  "x": "g",
  "y": "v",
  "z": "l"
}