{
  "a": "k",
  "b": "j",
  "c": "f",
  "d": "o",
  "e": "u",
  "f": "w",
  "g": "d",
  "h": "h",
  "i": "i",
  "j": "v",
  "k": "a",
  "l": "m",
  "m": "e",
  "n": "y",
  "o": "c",
  "p": "b",
  "q": "z",
  "r": "t",
  "s": "p",
  "t": "r",
  "u": "l",
  "v": "q",
  "w": "s",
  "x": "n",
  "y": "x",
  "z": "g"
}