{
  "a": "x",
  "b": "r",
  "c": "h",
  "d": "w",
  "e": "t",
  "f": "p",
  "g": "m",
  "h": "g",
  "i": "l",
  "j": "y",
  "k": "z",
  "l": "o",
  "m": "a",
  "n": "b",
  "o": "d",
  "p": "c",
  "q": "q",
  "r": "n",
  "s": "e",
  "t": "f",
  "u": "s",
  "v": "j",
  "w": "u",
  "x": "v",
  "y": "i",
  "z": "k"
}