{
  "a": "r",
  "b": "b",
  "c": "g",
  "d": "l",
  "e": "a",
  "f": "j",
  "g": "o",
  "h": "d",
  "i": "k",
  "j": "e",
  "k": "v",
  "l": "m",
  "m": "z",
  "n": "i",
  "o": "w",
  "p": "n",
  "q": "y",
  "r": "q",
  "s": "h",
  "t": "x",
  "u": "t",
  "v": "c",
  "w": "f",
  "x": "p",
  "y": "u",
  "z": "s"
}