{
  "a": "g",
  "b": "w",
  "c": "a",
  "d": "i",
  "e": "r",
  "f": "y",
  "g": "q",
  "h": "o",
  "i": "d",
  "j": "m",
  "k": "f",
  "l": "n",
  "m": "z",
  "n": "k",
  "o": "h",
  "p": "b",
  "q": "u",
  "r": "c",
  "s": "s",
  "t": "x",
  "u": "j",
  "v": "e",
  "w": "t",
  "x": "l",
  "y": "p",
  "z": "v"
}