{
  "a": "a",
  "b": "m",
  "c": "o",
  "d": "b",
  "e": "c",
  "f": "u",
  "g": "p",
  "h": "l",
  "i": "d",
  "j": "e",
  "k": "f",
  "l": "g",
  "m": "r",
  "n": "h",
  "o": "k",
  "p": "n",
  "q": "q",
  "r": "z",
  "s": "j",
  "t": "i",
  "u": "s",
  "v": "v",
  "w": "w",
  "x": "y",
  "y": "x",
  "z": "t"
}