{
  "a": "f",
  "b": "l",
  "c": "y",
  "d": "c",
  "e": "k",
  "f": "j",
  "g": "g",
  "h": "q",
  "i": "s",
  "j": "r",
  "k": "t",
  "l": "b",
  "m": "w",
  "n": "a",
  "o": "d",
  "p": "o",
  "q": "x",
  "r": "z",
  "s": "p",
  "t": "h",
  "u": "e",
  "v": "i",
  "w": "n",
  "x": "v",
  "y": "m",
  "z": "u"
}