{
  "a": "f",
  "b": "o",
  "c": "l",
  "d": "w",
  "e": "e",
  "f": "p",
  "g": "z",
  "h": "d",
  "i": "c",
  "j": "m",
  "k": "b",
  "l": "h",
  "m": "j",
  "n": "i",
  "o": "q",
  "p": "x",
  "q": "a",
  "r": "g",
  "s": "r",
  "t": "k",
  "u": "n",
  "v": "u",
  "w": "t",
  "x": "v",
  "y": "s",
  "z": "y"
}