{
  "a": "v",
  "b": "x",
  "c": "p",
  "d": "h",
  "e": "y",
  "f": "d",
  "g": "m",
  "h": "u",
  "i": "r",
  "j": "z",
  "k": "n",
  "l": "w",
  "m": "j",
  "n": "b",
  "o": "o",
  "p": "s",
  "q": "f",
  "r": "t",
  "s": "k",
  "t": "a",
  "u": "g",
  "v": "c",
  "w": "e",
  "x": "i",
  "y": "q",
  "z": "l"
}