{
  "a": "p",
  "b": "c",
  "c": "g",
  "d": "m",
  "e": "j",
  "f": "r",
  "g": "b",
  "h": "a",
  "i": "k",
  "j": "z",
  "k": "n",
  "l": "v",
  "m": "t",
  "n": "i",
  "o": "l",
  "p": "u",
  "q": "x",
  "r": "h",
  "s": "f",
  "t": "y",
  "u": "s",
  "v": "w",
  "w": "e",
  "x": "d",
  "y": "o",
  "z": "q"
}