{
  "a": "r",
  "b": "t",
  "c": "w",
  "d": "v",
  "e": "e",
  "f": "q",
  "g": "s",
  "h": "k",
  "i": "c",
  "j": "d",
  "k": "n",
  "l": "o",
  "m": "z",
  "n": "g",
  "o": "f",
  "p": "x",
  "q": "l",
  "r": "j",
  "s": "u",
  "t": "b",
  "u": "a",
  "v": "i",
  "w": "y",
  "x": "h",
  "y": "m",
  "z": "p"
}