{
  "a": "p",
  "b": "l",
  "c": "t",
  "d": "c",
  "e": "a",
  "f": "n",
  "g": "w",
  "h": "i",
  "i": "d",
  "j": "o",
  "k": "r",
  "l": "z",
  "m": "e",
  "n": "k",
  "o": "s",
  "p": "y",
  "q": "b",
  "r": "h",
  "s": "f",
  "t": "q",
  "u": "u",
  "v": "j",
  "w": "x",
  "x": "g",
  "y": "m",
  "z": "v"
}