{
  "a": "g",
  "b": "c",
  "c": "n",
  "d": "d",
  "e": "r",
  "f": "i",
  "g": "z",
  "h": "l",
  "i": "a",
  "j": "m",
  "k": "u",
  "l": "k",
  "m": "w",
  "n": "e",
  "o": "j",
  "p": "x",
  "q": "v",
  "r": "s",
  "s": "t",
  "t": "y",
  "u": "p",
  "v": "o",
  "w": "q",
  "x": "b",
  "y": "f",
  "z": "h"
}