{
  "a": "d",
  "b": "c",
  "c": "s",
  "d": "f",
  "e": "m",
  "f": "g",
  "g": "h",
  "h": "p",
  "i": "i",
  "j": "e",
  "k": "b",
  "l": "r",
  "m": "l",
  "n": "a",
  "o": "t",
  "p": "x",
  "q": "y",
  "r": "o",
  "s": "v",
  "t": "q",
  "u": "j",
  "v": "k",
  "w": "z",
  "x": "n",
  "y": "u",
  "z": "w"
}