{
  "a": "j",
  "b": "r",
  "c": "x",
  "d": "a",
  "e": "b",
  "f": "c",
  "g": "p",
  "h": "q",
  "i": "w",
  "j": "h",
  "k": "e",
  "l": "v",
  "m": "n",
  "n": "f",
  "o": "g",
  "p": "k",
  "q": "t",
  "r": "l",
  "s": "i",
  "t": "d",
  "u": "y",
  "v": "u",
  "w": "m",
  "x": "s",
  "y": "o",
  "z": "z"
}