{
  "a": "o",
  "b": "a",
  "c": "w",
  "d": "q",
  "e": "p",
  "f": "v",
  "g": "j",
  "h": "y",
  "i": "n",
  "j": "r",
  "k": "l",
  "l": "b",
  "m": "f",
  "n": "g",
  "o": "i",
  "p": "s",
  "q": "m",
  "r": "u",
  "s": "c",
  "t": "k",
  "u": "h",
  "v": "d",
  "w": "t",
  "x": "e",
  "y": "z",
  "z": "x"
}