{
  "a": "h",
  "b": "g",
  "c": "n",
  "d": "a",
  "e": "u",
  "f": "f",
  "g": "z",
  "h": "b",
  "i": "c",
  "j": "i",
  "k": "x",
  "l": "y",
  "m": "v",
  "n": "d",
  "o": "j",
  "p": "p",
  "q": "q",
  "r": "s",
  "s": "e",
  "t": "m",
  "u": "r",
  "v": "t",
  "w": "k",
  "x": "w",
  "y": "l",
  "z": "o"
}