{
  "a": "a",
  "b": "p",
  "c": "y",
  "d": "s",
  "e": "m",
  "f": "n",
  "g": "b",
  "h": "l",
  "i": "k",
  "j": "x",
  "k": "j",
  "l": "f",
  "m": "u",
  "n": "h",
  "o": "z",
  "p": "g",
  "q": "c",
  "r": "o",
  "s": "t",
  "t": "v",
  "u": "e",
  "v": "q",
  "w": "d",
  "x": "r",
  "y": "w",
  "z": "i"
}