{
  "a": "g",
  "b": "n",
  "c": "a",
  "d": "q",
  "e": "k",
  "f": "w",
  "g": "u",
  "h": "x",
  "i": "i",
  "j": "c",
  "k": "p",
  "l": "s",
  "m": "z",
  "n": "t",
  "o": "o",
  "p": "b",
  "q": "e",
  "r": "h",
  "s": "r",
  "t": "m",
  "u": "v",
  "v": "l",
  "w": "j",
  "x": "d",
  "y": "f",
  "z": "y"
}