{
  "a": "s",
  "b": "x",
  "c": "j",
  "d": "u",
  "e": "e",
  "f": "d",
  "g": "v",
  "h": "h",
  "i": "c",
  "j": "b",
  "k": "t",
  "l": "r",
  "m": "a",
  "n": "l",
  "o": "m",
  "p": "w",
  "q": "f",
  "r": "g",
  "s": "k",
  "t": "z",
  "u": "p",
  "v": "y",
  "w": "n",
  "x": "o",
  "y": "i",
  "z": "q"
}