{
  "a": "a",
  "b": "t",
  "c": "c",
  "d": "d",
  "e": "m",
  "f": "q",
  "g": "v",
  "h": "r",
  "i": "w",
  "j": "o",
  "k": "p",
  "l": "k",
  "m": "x",
  "n": "z",
  "o": "j",
  "p": "n",
  "q": "y",
  "r": "f",
  "s": "h",
  "t": "u",
  "u": "s",
  "v": "l",
  "w": "i",
  "x": "g",
  "y": "b",
  "z": "e"
}