{
  "a": "b",
  "b": "t",
  "c": "w",
  "d": "v",
  "e": "m",
  "f": "e",
  "g": "u",
  "h": "q",
  "i": "l",
  "j": "z",
  "k": "d",
  "l": "a",
  "m": "o",
  "n": "s",
  "o": "k",
  "p": "y",
  "q": "x",
  "r": "c",
  "s": "i",
  "t": "g",
  "u": "j",
  "v": "r",
  "w": "n",
  "x": "f",
  "y": "p",
  "z": "h"
}