{
  "a": "z",
  "b": "l",
  "c": "j",
  "d": "d",
  "e": "t",
  "f": "h",
  "g": "c",
  "h": "w",
  "i": "e",
  "j": "x",
  "k": "u",
  "l": "n",
  "m": "o",
  "n": "r",
  "o": "m",
  "p": "q",
  "q": "v",
  "r": "k",
  "s": "s",
  "t": "b",
  "u": "y",
  "v": "a",
  "w": "g",
  "x": "i",
  "y": "p",
  "z": "f"
}